1111111111111
1C01000100001
1000011111001
1P0011E000001
1C01000100001
1000011111001
1000110000101
1111111111111
