1111111111111
1C01010000001
10000100100C1
1000000010111
1C01001100001
100001E111001
1000110P00001
1111111111111
