1111111111111
1C01000100001
1000010111001
100011E000001
1C01000100001
1000010111001
100011P000101
1111111111111
