1111111
100E001
1111101
1P00001
1000001
1111111