1111111
100E001
1011001
1P00001
1000001
1111111