1111111
1000E01
1011001
1010001
1P0C001
1111111
