1111111111111111111111111111111111
100000000000000C00000C000000000001
10100101001000B0P01001000000010101
10100100101000E0001001000000010101
100000000C00C0000000000000000000C1
1111111111111111111111111111111111