1111111
1PE0001
1000001
1000001
1111011
1000001
1000001
1000001
1000001
1000001
1000001
1111111