1111111
1000E01
1011001
1P10001
100C001
1111111
